222222222222222222222222222222222222222222222
222222222222222222222222222222222222222222222
220000000334440000000000000044440044300000022
220000000334440000000000000044440044300000022
220033000000000000000000000000000000000330022
220033000000000000000000000000000000000330022
224411440000111111100133311444400100044114422
224411440011111144100133311444400111044114422
224400000011111144100133311444400111000004422
224400000111111111100111111111100111100003322
224400000000000000000000000000000000000003322
224400000000000000000000000000000000000004422
220000000000000000000000000000000000000000022
220000000444444004444444444440044444400000022
220000000113311001111111111110011331100000022
220000000113311001111111111110011331100000022
220000000113444444444444444444444331100000022
221111100113444444444444444444444331101111122
224444100113333001111111111110033331101444422
224444100113333001111111111110033331101444422
224444100011111111113333331111111110001444422
224444100011111111111333311111111110001444422
221111100011111444411133111444441110001111122
220000000011111444411111111444441110000000022
220000000011111444411111111444441110000000022
220000000011111444411111111444441110000000022
220000000000000000000000000000000000000000022
220000110000000000000000000000000000011000022
220000110444400111111133111111110044411000022
220000110111100000011333311000000011111000022
220000110111100000013333331000000011111000022
220000440111100000444444444000000011144000022
220000000111100000000000004000000011100000022
221111000333300000011111114000000033300111122
221111000333300000011666661140000000333001122
223334441114444000011666661140000444411443322
223334441114444000011666661140000444411443322
223334441114444000011666661140000444411443322
222222222222222222222222222222222222222222222
222222222222222222222222222222222222222222222

