222222222222222222222222222222222222222222222
222222222222222222222222222222222222222222222
220000000444400000004444000000003333000000022
220000000444400000004444000000003333000000022
220044441111111333001111113333111111004444422
220044441144111333001111113333114411004444422
220044441144111333001111113333114411004444422
220044441111111333001111113333111111004444422
220440000000004400004444000000000444000000022
220440001111104400004444000000000444000000022
220000001444100000011000000110000000000000022
220111001444100000011000000110000000044411122
220111001444144114411442244114411110044411122
220111001444144114411442244114444440044411122
220111001111100000000000000004411110044411122
220000000000004444444444444404433330000000022
220000000000004444444444444400011110000000022
224433001111000000000000000000044440000033022
224433001441000000334433300044011110000033022
220011001441000000444444444044000000440011122
220011001111000000444444444000000000440011122
220011000440111100111101111001111000000011122
224400000440111100111101111001111044000011122
224400010440110440001101100440011044001000022
220000131440110440001101100440011440014100022
224401303100110033001101100330011440140410022
224413000310110033001101100330011001400041022
220001303100110444401101104444011000140410022
220000131000110444401101104444011440014104422
220440010000110444401101104444011440001004422
220440000000110444401101104444011000000000022
220000000044000000000000000004400033000000022
220000000044000444000000000004400033000000022
220011441100111444011111111140003300114410022
220011441100111400011666661144400033001140022
220011441100133400011666661144400033001140022
220011441100133400011666661144400033001140022
220011441100111400011666661144400000001140022
222222222222222222222222222222222222222222222
222222222222222222222222222222222222222222222

