222222222222222222222222222222222222222222222
222222222222222222222222222222222222222222222
220000000000000000000000000000000000000000022
220000000000000000000000000000000000000000022
220011100111000001111000011110000111001110022
220011100111000001111000011110000111001110022
220011100111444441111000011114444111001110022
220011100111444441111000011114444111001110022
220011100111444441111333311114444111001110022
220011100111444441111333311114444111001110022
220013333331444441111333311114444111001110022
220013333331444441111333311114444133333310022
220013300111444441111333311114444133333310022
220013300111444441111333311114444111003310022
220013300111000001111000011110000111003310022
220011100111000001111000011110000111001110022
220033300333000004444444444440000333003330022
220033300333000004444444444440000333003330022
220000000000000000000000000000000000000000022
220000000000000000000000000000000000000000022
221111100111330000000000000000033111001111122
221133300111330000000000000000033111003331122
221133300111110001333333333100011111003331122
220000000000000001333333333100000000000000022
220000000000000001114444411100000000000000022
220001144413300001114444411100011444111100022
220001144413300001111111111100011444111100022
220001144411100001111111111100033444111100022
220001144411100001111111111100033444111100022
220001144413300001111333111100011444111100022
220001144413300001114333411100011444111100022
220001144411100004444444444400033444111100022
220001144411100004441111144400033444111100022
220001144411100000011111111100033444111100022
220001144413300000011666661100001144411110022
220011444133000000011666661100000114441111022
220001111111100000011666661100000111133333322
220001111111100000011666661100000111133333322
222222222222222222222222222222222222222222222
222222222222222222222222222222222222222222222
