222222222222222222222222222222222222222222222
222222222222222222222222222222222222222222222
220000000444400000004444000000003330000000022
220000000444400000004444000000003330000000022
220000000144400330001111113300011110044444022
220044441144400330000111113300011410044444022
220044441144400330000111113300011410044444022
220044441144400330001111113300011110044444022
220000000000000444444444444440000000000000022
224400001111100444444444444440000000000000022
224400001444100111111111111110011110011111022
220011001444100100114441110010033330014441022
220011001444100100114441110010011110014441022
220011001444100111111111111110044440014441022
220011001111100000044444440000011110014441022
220033300000000000044444440000033330011111022
220033300000044444444444444444000000443333022
220000000000044444444444444444000000443333022
220000004444033333333333333344000000443333022
224411004444000000000000000044000004400000022
224411004444001100111001110011000004400000022
224411000000001100111001110011000444400000022
220011000000111111133333311111110444400000022
220000010000111111113333111111110444401004422
220000131000444111111331111114440440014104422
220001343100444001444444100004440440143410022
220013444310444001444444100004440441433341022
220001343100444111444444111114440440143410022
220000131000111111444444111111110440014100022
224400010000110010011111001110010440001000022
224400000000110010011111001110010440000000022
224400444000111444444444444441110440044400022
224400000000000000000000000000000000044400022
224411441110000011011111110011000011114411022
220011440010004444011666661100110000100141022
220011440010004444011666661100110000100144022
220011441110000000011666661100004444111144022
220011440000000000011666661100004444000044022
222222222222222222222222222222222222222222222
222222222222222222222222222222222222222222222
